hello|привет|
dog|собака|
cat|кошка|
horse|лошадь|
fox|лиса|
mouse|мышь|
wolf|волк|
house|дом|
chair|стул|
table|стол|
question|вопрос|
answer|ответ|
circle|круг|
square|площадь|
fish|рыба|
ocean|океан|
meal|еда|
dish|блюдо|
bread|хлеб|
tea|чай|
juice|сок|
fork|вилка|
spoon|ложка|
car|машина|
road|дорога|
tree|дерево|
flower|цветок|
window|окно|
floor|стол|
door|дверь|

